1111111111111
100E00P000001
1010101010101
1010101010101
1C00000000001
1111111111111
